[11,13]
(2,5)
(10,5)
(2,3,2,2)
(2,6,2,2)
(3,5,7,1)
(9,3,2,2)
(9,6,2,2)